Investors betting on a friendly U.S. regulatory shift | drove | Bitcoin above $100,000
Federal Reserve chief Jerome Powellâ€™s upbeat comments on the economy | bolstered | market sentiment
Bolstered market sentiment | caused | world stocks to touch fresh record highs
Far-right and leftist lawmakers joining forces | caused | France's government to lose a confidence vote
Lawmakers joining forces | toppled | Michel Barnier's government
Investors | widely anticipated | the government collapse
Wide anticipation of the collapse | caused | euro, French stocks, and bonds to remain steady
Michel Barnier | officially resigned | from government
Comments from Fed Chair Powell | helped | U.S. stock indexes score record closing highs (Wednesday)
Dow Jones Industrial Average | fell | 0.22%
S&P 500 | rose | 0.09%
Nasdaq Composite | gained | 0.19%
Economy being stronger than expected | allowed | policymakers to be more cautious in reducing rates
Central bank | began | cutting interest rates (in September)
Fall in U.S. Treasury yields | supported | sentiment in equity markets
Relatively robust U.S. data | supported | sentiment in equity markets
Powell's latest comments | supported | sentiment in equity markets
Francois Savary | identifies | risk to the current market euphoria
Trump taking power (in January) | requires | implementation of economic plans
Implementation of economic plans | could generate | potential inflationary impact
Bitcoin | hit | the $100,000 mark
Trump saying he would nominate Paul Atkins | followed/fueled | Bitcoin's latest surge
Paul Atkins | holds | pro-crypto and pro-deregulation stance
Paul Atkins | nominated to run | Securities and Exchange Commission
Industry becoming institutionalized | allowed | Bitcoin to reach current price levels
ETF inflows | drove | industry institutionalization
U.S. rate-cut optimism | supported | sentiment across broader markets
Markets | priced in | an extra U.S. rate cut for 2025
Market expectations | lifted | implied chance of December cut to 70%
Fed Governor Christopher Waller | leaned towards | a rate cut in December
U.S. ISM survey | showed | services sector activity slowed
Services sector activity | posted | big gains (in recent months)
Investors digesting higher jobless claims data | caused | Benchmark 10-year Treasury yields to edge up
New data | showed | increased applications for unemployment benefits
Increased unemployment applications | suggested | labor market continued to steadily cool
The dollar | weakened | 0.4% against major currencies
Dollar weakness | caused | euro to rise 0.5%
Widely expected government collapse | caused | risk premium on French debt to drop
Bank stocks | aided | European stocks to reach one-month high
Investors' hope for a new budget | influenced | positive market sentiment
Pan-European STOXX 600 | finished | 0.4% higher
France's CAC 40 | ended | 0.3% higher
Market | priced in | bad news regarding French government
President Yoon Suk Yeol's failed martial law attempt | triggered | volatility and political crisis
Post-crisis stabilization | resulted in | broadly steady financial markets in South Korea
Investors weighing ample supply vs OPEC+ delay | kept | oil prices steady
OPEC+ | delayed | production increase to April 2025
U.S. crude | fell | 0.1%
Brent crude | declined | 0.04%