Profit taking | caused | Bitcoin to trade closer to $98,000
Comments from Russian President Vladimir Putin | contributed to | the surge past $100K
Comments from Federal Reserve Chairman Jerome Powell | contributed to | the surge past $100K
Donald Trump's nomination of Paul Atkins | contributed to | the surge past $100K
Increasing demand | caused | analysts to set price targets above $100,000
Limited supply | caused | analysts to set price targets above $100,000
Encouraging words from Vladimir Putin | boosted | Bitcoin to a high of more than $103,000
Encouraging words from Jerome Powell | boosted | Bitcoin to a high of more than $103,000
Trump's pick for SEC Chair | boosted | Bitcoin to a high of more than $103,000
Profit taking | caused | Bitcoin to trade lower Thursday afternoon
History of volatility | failed to deter | confidence of Bitcoin bulls
Trump picking pro-crypto Paul Atkins | caused | Bitcoin investors to cheer
Agency's enforcement approach under Gensler | caused | market watchers to monitor the appointment
Gary Gensler | announced | resignation date of Jan. 20
Trump | took | credit for cryptocurrency's latest price milestone
Trump winning 2024 election | drove | Bitcoin's recent rally
Trump's victory | expected to be | positive development for crypto industry
Putin | encouraged | Bitcoin investors
U.S. using dollar for political purposes | undermined | dollar's role as global reserve currency
Undermining dollar's role | forced | countries to look for alternatives
No one | can prohibit | Bitcoin (according to Putin)
Bitcoin supporters | touted | cryptocurrency as "digital gold"
Fed Chair Powell | validated | "digital gold" comparison
Powell | deems | Bitcoin a competitor for gold
Bernstein analysts | expect | Bitcoin to replace Gold as store of value
Limit of 21 million coins | keeps | Bitcoin believers undeterred
Finite supply and increasing demand | dictate | long-term price increase
Explosive demand for fixed supply | characterizes | Bitcoin market
Traditional commodities companies | increase | production to satisfy demand
Breaching $100,000 barrier | made | earlier predictions seem surmountable
Bernstein analysts | expect | cycle-high of $200,000 in late 2025
Technical analysis | suggests | potential price of $129,930
Profit-taking | could trigger | a downtrend
Bull market nature | ensures | pullbacks will occur
Matt Hougan | predicts | less severe Bitcoin price drops
Bitcoinâ€™s finite supply | makes | it a better investment than gold (according to Saylor)
Outperformance versus stock markets | makes | Bitcoin a better investment than gold
Inherent volatile nature | makes | Bitcoin a better investment than gold
24/7 global trading nature | contributes to | volatility being a "feature"